*******************
*      *          *
* ** A  *   *******
* **    *     *   *
*  *    ****  * G**
*  *        *  * G*
*               GG*
*D   G*************
*******************