************************************************
*      *              *                    A   *
* ** A  *   ********** *             *   *     *
* **    *     *      * * *******     *****     *
*  *    ****  * G*   *   GGG      *  *         *
*  *        *  * G*   *******     *  ******    *
*               GG* *       *     *       **   *
*****G********************  *  ********   *    *
************************************************