************************************************
*      *              *                    A   *
* ** A  *   ********** *             *   *     *
* **    *     *      * * *******     *****     *
*  *    ****  * G*   *   GGG      *  *D     D  *
*  *        *  * G*   *******     *  ******    *
*               GG* *     D *    D*       **   *
*****G********************  *  ********   *    *
************************************************